00C0000C0000
000000000000
0000P0000000
000000000E00
000000000000
