11111111111111
100C0000C00001
1000C000000001
1C000E00000001
100000C0000001
1000C0000C0001
11111111111111
