1111111111111111111111111111111111
1E1000000000000C00000C000000000001
1100010100100P00101001000000010101
1010010010101010001001000000010101
10C000000C00C0000000000000000000C1
1111111111111111111111111111111111
