1111111
1000001
1C0P0E1
1000001
1111111
0000000