1111111
1000001
1X0P0E1
1000001
1111111
